{
    "compose_ids": [
        201328319, 
        201330118, 
        201339863, 
        201334735, 
        201340447, 
        201340571, 
        201343451, 
        201344134, 
        201348060, 
        201346444, 
        201343522, 
        201355961, 
        201357159, 
        201358143, 
        201358653, 
        201358955, 
        201359244, 
        201359815, 
        201361486, 
        201357218, 
        201362634, 
        201367872, 
        201368865, 
        201370082, 
        201370622, 
        201370841, 
        201372630, 
        201373450, 
        201374418, 
        201374875, 
        201375441, 
        201380459, 
        201383918, 
        201386498, 
        201340924, 
        201348249, 
        201387033, 
        134224090, 
        134239239, 
        10000, 
        10001, 
        10002, 
        201327267, 
        201328391, 
        201329172, 
        201330420, 
        201330934, 
        201333717, 
        201334380, 
        201335717, 
        201342532, 
        201349380, 
        201354090, 
        201355407, 
        201355767, 
        201355950, 
        201359979, 
        201366344, 
        201366634, 
        201366764, 
        201368973, 
        201371647, 
        201375130, 
        201375489, 
        201382373, 
        201383459, 
        201385833, 
        201388520, 
        201390941, 
        134217898, 
        134218066, 
        134219517, 
        134219666, 
        134226498, 
        134227099, 
        134228198, 
        134228783, 
        134230023, 
        134230030, 
        134230321, 
        134231020, 
        134231476, 
        134231692, 
        134232123, 
        134233371, 
        134234364, 
        134234522, 
        134234932, 
        134235011, 
        134236143, 
        134236144, 
        134236893, 
        134237146, 
        134238715, 
        134240022, 
        134240836, 
        134241450, 
        134241935, 
        134242543, 
        134242829, 
        134243139, 
        134243528, 
        134245454, 
        134245522, 
        134247318, 
        134247356, 
        134249561, 
        134249779, 
        134250337, 
        134251797, 
        134252843, 
        134254253, 
        134254470, 
        134255426, 
        134255734, 
        134256262, 
        134258194, 
        134258331, 
        134258411, 
        134259573, 
        134261866, 
        134262949, 
        134263324, 
        134263842, 
        134264009, 
        134264913, 
        134266669, 
        134267055, 
        134267428, 
        134267465, 
        134268483, 
        134269297, 
        134269598, 
        134269810, 
        134270554, 
        134272119, 
        134272951, 
        134273029, 
        134274595, 
        134277940, 
        134279244, 
        134279496, 
        134279535, 
        134282830
    ], 
    "item_id_seed": 0
}